"filename", "language", "SCSS", "JavaScript", "comment", "blank", "total"
"c:\Users\khang\Desktop\FBLA\2024-25\SLC\slc-app\src\components\AccountPage\AchieveComp\index.js", "JavaScript", 0, 119, 4, 22, 145
"c:\Users\khang\Desktop\FBLA\2024-25\SLC\slc-app\src\components\AccountPage\HistoryComp\index.js", "JavaScript", 0, 117, 4, 16, 137
"c:\Users\khang\Desktop\FBLA\2024-25\SLC\slc-app\src\components\AccountPage\ProjectComp\index.js", "JavaScript", 0, 61, 14, 14, 89
"c:\Users\khang\Desktop\FBLA\2024-25\SLC\slc-app\src\components\AccountPage\SkillComp\index.js", "JavaScript", 0, 104, 2, 16, 122
"c:\Users\khang\Desktop\FBLA\2024-25\SLC\slc-app\src\components\AccountPage\index.js", "JavaScript", 0, 112, 2, 22, 136
"c:\Users\khang\Desktop\FBLA\2024-25\SLC\slc-app\src\components\AccountPage\index.scss", "SCSS", 39, 0, 0, 9, 48
"c:\Users\khang\Desktop\FBLA\2024-25\SLC\slc-app\src\components\ContactDashBoard\DashBoardFAQ\index.js", "JavaScript", 0, 0, 0, -1, -1
"c:\Users\khang\Desktop\FBLA\2024-25\SLC\slc-app\src\components\ContactDashBoard\DashBoardFAQ\index.scss", "SCSS", 14, 0, 0, 3, 17
"c:\Users\khang\Desktop\FBLA\2024-25\SLC\slc-app\src\components\ContactDashBoard\DashBoardStatistic\index.js", "JavaScript", 0, -62, -5, -6, -73
"c:\Users\khang\Desktop\FBLA\2024-25\SLC\slc-app\src\components\ContactDashBoard\DashBoardStatistic\index.scss", "SCSS", -221, 0, -23, -40, -284
"c:\Users\khang\Desktop\FBLA\2024-25\SLC\slc-app\src\components\ContactDashBoard\index.js", "JavaScript", 0, -1, 0, 0, -1
"c:\Users\khang\Desktop\FBLA\2024-25\SLC\slc-app\src\components\Footer\index.js", "JavaScript", 0, -3, 0, 0, -3
"c:\Users\khang\Desktop\FBLA\2024-25\SLC\slc-app\src\components\Footer\index.scss", "SCSS", 6, 0, 1, 2, 9
"c:\Users\khang\Desktop\FBLA\2024-25\SLC\slc-app\src\components\Home\HomeCard\index.js", "JavaScript", 0, -2, -9, 0, -11
"c:\Users\khang\Desktop\FBLA\2024-25\SLC\slc-app\src\components\Home\HomeCard\index.scss", "SCSS", 12, 0, 0, 2, 14
"c:\Users\khang\Desktop\FBLA\2024-25\SLC\slc-app\src\components\Interior\JobPost\index.js", "JavaScript", 0, 9, 0, 3, 12
"c:\Users\khang\Desktop\FBLA\2024-25\SLC\slc-app\src\components\Interior\index.js", "JavaScript", 0, 5, 0, 0, 5
"Total", "-", -150, 459, -10, 62, 361