"filename", "language", "JavaScript", "SCSS", "JSON", "comment", "blank", "total"
"c:\Users\khang\Desktop\FBLA\2024-25\SLC\slc-app\package-lock.json", "JSON", 0, 0, 172, 0, 0, 172
"c:\Users\khang\Desktop\FBLA\2024-25\SLC\slc-app\package.json", "JSON", 0, 0, 9, 0, 0, 9
"c:\Users\khang\Desktop\FBLA\2024-25\SLC\slc-app\src\App.js", "JavaScript", -1, 0, 0, 0, 0, -1
"c:\Users\khang\Desktop\FBLA\2024-25\SLC\slc-app\src\components\ContactDashBoard\DashBoardFAQ\index.js", "JavaScript", -90, 0, 0, 0, 2, -88
"c:\Users\khang\Desktop\FBLA\2024-25\SLC\slc-app\src\components\ContactDashBoard\DashBoardFAQ\index.scss", "SCSS", 0, 1, 0, 0, 0, 1
"c:\Users\khang\Desktop\FBLA\2024-25\SLC\slc-app\src\components\ContactDashBoard\index.js", "JavaScript", -1, 0, 0, 0, 0, -1
"c:\Users\khang\Desktop\FBLA\2024-25\SLC\slc-app\src\components\ContactDashBoard\sideBarComp\index.js", "JavaScript", -1, 0, 0, 1, 0, 0
"c:\Users\khang\Desktop\FBLA\2024-25\SLC\slc-app\src\components\EmbededForm\index.js", "JavaScript", -12, 0, 0, 0, -2, -14
"c:\Users\khang\Desktop\FBLA\2024-25\SLC\slc-app\src\components\EmbededForm\index.scss", "SCSS", 0, -9, 0, 0, -1, -10
"c:\Users\khang\Desktop\FBLA\2024-25\SLC\slc-app\src\components\Footer\index.scss", "SCSS", 0, 1, 0, 0, 0, 1
"c:\Users\khang\Desktop\FBLA\2024-25\SLC\slc-app\src\components\Home\HomeCard\index.js", "JavaScript", -29, 0, 0, 25, -6, -10
"c:\Users\khang\Desktop\FBLA\2024-25\SLC\slc-app\src\components\Home\HomeCard\index.scss", "SCSS", 0, 189, 0, 27, 34, 250
"c:\Users\khang\Desktop\FBLA\2024-25\SLC\slc-app\src\components\Home\index.js", "JavaScript", -2, 0, 0, 0, -1, -3
"c:\Users\khang\Desktop\FBLA\2024-25\SLC\slc-app\src\components\Home\index.scss", "SCSS", 0, 14, 0, 0, 4, 18
"c:\Users\khang\Desktop\FBLA\2024-25\SLC\slc-app\src\components\Interior\index.js", "JavaScript", 61, 0, 0, 0, 8, 69
"c:\Users\khang\Desktop\FBLA\2024-25\SLC\slc-app\src\components\Interior\index.scss", "SCSS", 0, 3, 0, 0, 3, 6
"c:\Users\khang\Desktop\FBLA\2024-25\SLC\slc-app\src\components\Layout\index.js", "JavaScript", -1, 0, 0, 0, 0, -1
"c:\Users\khang\Desktop\FBLA\2024-25\SLC\slc-app\src\components\MenuInterior\index.js", "JavaScript", 0, 0, 0, 0, -1, -1
"c:\Users\khang\Desktop\FBLA\2024-25\SLC\slc-app\src\components\SignIn\index.js", "JavaScript", 5, 0, 0, 0, 0, 5
"c:\Users\khang\Desktop\FBLA\2024-25\SLC\slc-app\src\components\SignIn\index.scss", "SCSS", 0, 16, 0, 1, 5, 22
"c:\Users\khang\Desktop\FBLA\2024-25\SLC\slc-app\src\components\SignUp\index.js", "JavaScript", 28, 0, 0, 1, 5, 34
"c:\Users\khang\Desktop\FBLA\2024-25\SLC\slc-app\src\components\SignUp\index.scss", "SCSS", 0, 7, 0, 0, 2, 9
"c:\Users\khang\Desktop\FBLA\2024-25\SLC\slc-app\webpack.config.js", "JavaScript", 12, 0, 0, 0, 2, 14
"Total", "-", -31, 222, 181, 55, 54, 481