"filename", "language", "JavaScript", "SCSS", "comment", "blank", "total"
"c:\Users\khang\Desktop\FBLA\2024-25\SLC\slc-app\src\components\AccountPage\AchieveComp\index.js", "JavaScript", -2, 0, 0, 0, -2
"c:\Users\khang\Desktop\FBLA\2024-25\SLC\slc-app\src\components\AccountPage\AchieveComp\index.scss", "SCSS", 0, 2, 0, 0, 2
"c:\Users\khang\Desktop\FBLA\2024-25\SLC\slc-app\src\components\AccountPage\index.js", "JavaScript", -1, 0, 0, -1, -2
"c:\Users\khang\Desktop\FBLA\2024-25\SLC\slc-app\src\components\AccountPage\index.scss", "SCSS", 0, 18, 0, 2, 20
"c:\Users\khang\Desktop\FBLA\2024-25\SLC\slc-app\src\components\ContactDashBoard\DashBoardContact\index.js", "JavaScript", 11, 0, 7, 5, 23
"c:\Users\khang\Desktop\FBLA\2024-25\SLC\slc-app\src\components\ContactDashBoard\DashBoardFAQ\index.js", "JavaScript", 28, 0, 6, 2, 36
"c:\Users\khang\Desktop\FBLA\2024-25\SLC\slc-app\src\components\ContactDashBoard\DashBoardFAQ\index.scss", "SCSS", 0, 0, 7, -2, 5
"c:\Users\khang\Desktop\FBLA\2024-25\SLC\slc-app\src\components\ContactDashBoard\DashBoardStatistic\index.js", "JavaScript", 0, 0, 67, 6, 73
"c:\Users\khang\Desktop\FBLA\2024-25\SLC\slc-app\src\components\ContactDashBoard\DashBoardStatistic\index.scss", "SCSS", 0, 0, 236, 38, 274
"c:\Users\khang\Desktop\FBLA\2024-25\SLC\slc-app\src\components\ContactDashBoard\sideBarComp\index.scss", "SCSS", 0, 1, 0, 1, 2
"c:\Users\khang\Desktop\FBLA\2024-25\SLC\slc-app\src\components\Home\HomeCard\index.js", "JavaScript", -2, 0, -34, -1, -37
"c:\Users\khang\Desktop\FBLA\2024-25\SLC\slc-app\src\components\Home\HomeCard\index.scss", "SCSS", 0, 79, 2, 18, 99
"c:\Users\khang\Desktop\FBLA\2024-25\SLC\slc-app\src\components\Interior\JobPost\index.js", "JavaScript", -4, 0, 0, -1, -5
"c:\Users\khang\Desktop\FBLA\2024-25\SLC\slc-app\src\components\Interior\JobPost\index.scss", "SCSS", 0, 4, 0, 1, 5
"c:\Users\khang\Desktop\FBLA\2024-25\SLC\slc-app\src\components\Interior\index.scss", "SCSS", 0, 2, 0, 0, 2
"c:\Users\khang\Desktop\FBLA\2024-25\SLC\slc-app\src\components\MenuInterior\index.scss", "SCSS", 0, 1, 0, 0, 1
"c:\Users\khang\Desktop\FBLA\2024-25\SLC\slc-app\src\components\MenubarLanding\index.js", "JavaScript", 0, 0, 1, 0, 1
"c:\Users\khang\Desktop\FBLA\2024-25\SLC\slc-app\src\components\MenubarLanding\index.scss", "SCSS", 0, 0, 0, -1, -1
"c:\Users\khang\Desktop\FBLA\2024-25\SLC\slc-app\src\components\SignUp\index.js", "JavaScript", 2, 0, 0, 0, 2
"c:\Users\khang\Desktop\FBLA\2024-25\SLC\slc-app\src\components\SignUp\index.scss", "SCSS", 0, 14, 1, 2, 17
"c:\Users\khang\Desktop\FBLA\2024-25\SLC\slc-app\src\components\UserPosts\index.js", "JavaScript", -3, 0, 17, -2, 12
"c:\Users\khang\Desktop\FBLA\2024-25\SLC\slc-app\src\components\UserPosts\index.scss", "SCSS", 0, 0, 6, 3, 9
"c:\Users\khang\Desktop\FBLA\2024-25\SLC\slc-app\src\context\AuthContext.js", "JavaScript", 0, 0, 15, -7, 8
"Total", "-", 29, 121, 331, 63, 544