"filename", "language", "JavaScript", "SCSS", "JSON", "comment", "blank", "total"
"c:\Users\khang\Desktop\FBLA\2024-25\SLC\slc-app\package-lock.json", "JSON", 0, 0, 10, 0, 0, 10
"c:\Users\khang\Desktop\FBLA\2024-25\SLC\slc-app\package.json", "JSON", 0, 0, 1, 0, 0, 1
"c:\Users\khang\Desktop\FBLA\2024-25\SLC\slc-app\src\App.js", "JavaScript", 2, 0, 0, 0, 0, 2
"c:\Users\khang\Desktop\FBLA\2024-25\SLC\slc-app\src\App.scss", "SCSS", 0, 0, 0, 0, 1, 1
"c:\Users\khang\Desktop\FBLA\2024-25\SLC\slc-app\src\components\AccountPage\index.js", "JavaScript", 18, 0, 0, 0, 6, 24
"c:\Users\khang\Desktop\FBLA\2024-25\SLC\slc-app\src\components\Footer\index.scss", "SCSS", 0, 2, 0, 0, 0, 2
"c:\Users\khang\Desktop\FBLA\2024-25\SLC\slc-app\src\components\Home\HomeCard\index.js", "JavaScript", 37, 0, 0, 0, 6, 43
"c:\Users\khang\Desktop\FBLA\2024-25\SLC\slc-app\src\components\Home\HomeCard\index.scss", "SCSS", 0, 25, 0, 0, 8, 33
"c:\Users\khang\Desktop\FBLA\2024-25\SLC\slc-app\src\components\Home\index.js", "JavaScript", 0, 0, 0, 0, 1, 1
"c:\Users\khang\Desktop\FBLA\2024-25\SLC\slc-app\src\components\Home\index.scss", "SCSS", 0, 1, 0, 0, 0, 1
"c:\Users\khang\Desktop\FBLA\2024-25\SLC\slc-app\src\components\Interior\AddPostBar\index.js", "JavaScript", 51, 0, 0, 1, 11, 63
"c:\Users\khang\Desktop\FBLA\2024-25\SLC\slc-app\src\components\Interior\JobPost\index.js", "JavaScript", 2, 0, 0, 0, 0, 2
"c:\Users\khang\Desktop\FBLA\2024-25\SLC\slc-app\src\components\Interior\index.js", "JavaScript", 1, 0, 0, 3, 9, 13
"c:\Users\khang\Desktop\FBLA\2024-25\SLC\slc-app\src\components\Interior\index.scss", "SCSS", 0, -76, 0, -18, -13, -107
"c:\Users\khang\Desktop\FBLA\2024-25\SLC\slc-app\src\components\MenuInterior\index.scss", "SCSS", 0, 1, 0, 0, 0, 1
"c:\Users\khang\Desktop\FBLA\2024-25\SLC\slc-app\src\components\MenubarLanding\index.js", "JavaScript", 3, 0, 0, -5, -1, -3
"c:\Users\khang\Desktop\FBLA\2024-25\SLC\slc-app\src\components\MenubarLanding\index.scss", "SCSS", 0, 11, 0, 0, 6, 17
"c:\Users\khang\Desktop\FBLA\2024-25\SLC\slc-app\src\components\SignIn\index.js", "JavaScript", 27, 0, 0, -6, 7, 28
"c:\Users\khang\Desktop\FBLA\2024-25\SLC\slc-app\src\components\SignIn\index.scss", "SCSS", 0, 17, 0, 1, 5, 23
"c:\Users\khang\Desktop\FBLA\2024-25\SLC\slc-app\src\components\SignUp\index.js", "JavaScript", -1, 0, 0, 0, 1, 0
"c:\Users\khang\Desktop\FBLA\2024-25\SLC\slc-app\src\components\UserPosts\index.js", "JavaScript", 119, 0, 0, 8, 22, 149
"c:\Users\khang\Desktop\FBLA\2024-25\SLC\slc-app\src\components\UserPosts\index.scss", "SCSS", 0, 42, 0, 0, 4, 46
"c:\Users\khang\Desktop\FBLA\2024-25\SLC\slc-app\src\context\AuthContext.js", "JavaScript", 94, 0, 0, 3, 24, 121
"c:\Users\khang\Desktop\FBLA\2024-25\SLC\slc-app\src\index.js", "JavaScript", 3, 0, 0, 0, 0, 3
"Total", "-", 356, 23, 11, -13, 97, 474